111111111111111
1000000000000P1
101101101101101
1C0000000000001
1011011E11011C1
100000000000001
1011011011C1101
1000C0000000001
111111111111111