111111111111111
1C0000C0101E001
101011011100101
1C000C011001101
1011100C00100C1
100111011010101
11C11100CC00101
100C00C1CC00CP1
111111111111111