111111111111111
1E01111P0000001
110000111111101
11111C1100000C1
10C010110111111
1010001100C0001
101111111111101
1000000C0000001
111111111111111