111111111111111111111111
110C00C00100C0100CC11C01
1P10C101001C0C01C00C10C1
10C10C101001C0C01C000C01
110C10C101001C0C01C01101
1110C10C10100000C01C1101
10110C1C0C01111C0C001101
1C0110C11100C110C0011101
10C0C00C01CC011C00111101
100C0C000100C110C11110C1
1C0100C10C01111C01111CE1
111111111111111111111111