1111111111
1000000001
100C000001
1000111001
10C01P1001
1000000001
10C000E001
1111111111