NO     ./bitmaps/north_test.xpm     
 SO  ./bitmaps/south_test.xpm
 
WE ./bitmaps/west_test.xpm 
EA ./bitmaps/east_test.xpm

F 160,160,160
C 0,128,255

111111111111111111111111111111111111111111
111111111111111111111111111111111111111111
110000000000000000000000000000000000000011
110001001111110000000111111110000000000011
110001001110000111111111111110000000000011
110001001100111111111111111110000000000111
110001000000000000000000000000000000000011
110001111111111111111110111100111111011111
110001100000000000000000000000011111011111
110001100111111111110011111111011111011111
110000000111001111110011100011011111011111
111111110000001111110011100011011111011111
110000000011111111110011100011010000011111
111100111111111111110011101111010111111111
111100000000000000000011101111010111111111
110010000001000001000011000000000000000011
110000000000000001000011000000000000000011
110010000001000001000011111111111111111011
110000N00000000001000011110000000000011011
110010000001000001000011110011111111011011
110000000000000001000011110011111100000011
110010000001000000000000000000000100000011
111111111111111111111111111111111111111111
111111111111111111111111111111111111111111