F 5,255,5
C 5,5,255

WE ./bitmaps/west_test.xpm    
EA ./bitmaps/east_test.xpm 

NO     ./bitmaps/north_test.xpm       
SO  ./bitmaps/fausse.xpm

1
        1111111111111111111111111
        100000000011000N000000001
        1011000001110000100000001
        100100000000000000000000111111111
        111111111011000001110000000000001
        100000000011000001110111111111111
        11110111111111011100000010001
        11110111111111011101010010001
        11000000110101011100000010001
        10000000000000001100000010001
11111111100000000000000011010100000011
10000001110101011111011110001111111101
11110111 1110101 101111010001111111111
11111111 1111111 111111111111111111111
1
