NO     ./bitmaps/north_test.xpm     
 SO  ./bitmaps/south_test.xpm
 
WE ./bitmaps/west_test.xpm 
EA ./bitmaps/east_test.xpm

F 255,255,0

C     255 ,  0     ,255                               


        111111111111111111111111111
        110011000000011000000000001
        11011000001110000000000N011
        100100000000000000000000011
1111111110110000011100000000000011
100000000011000001110111111111111
11110111111111011100000010001
11110111111111011101010010001
11000000000000000000000010001
100000000000000000000000100011
100000000000010001101010010001
110000011101010111110111101111
11110111 1110001 101111000101
11111111 1111111 111111111111     